# 聲母 Consonants
柳	l
邊	b
求	g
氣	k
低	d
波	p
他	t
曾	z
日	n
時	s
鶯	
蒙	m
語	ng
出	c
非	h
# ʒ	j
# β	w
# 韻母 Vowels
春公	ung
花瓜	ua
香姜	iong
秋周	iu
山干	ang
開哉	ai
嘉佳	a
賓京	ing
歡官	uang
歌高	o
須車	y
杯盃	uoi
孤姑	u
燈庚	eng
光	uong
輝龜	ui
燒嬌	ieu
銀恭	yng
釭綱	ong
之箕	i
東江	oeng
郊交	au
過朱	uo
西街	e
橋嬝	io
雞圭	ie
聲正	iang
催	oi
初梳	oe
天堅	ieng
奇迦	ia
歪乖	uai
溝勾	eu
桸𤬣	ya
伓	ng